###############
#s  #   #   # #
### # # # # # #
# # # #   # # #
# # # ##### # #
#   # #     # #
# ### # ##### #
#     #      e#
###############